wwwwwwwwwwwwwww
w0000000000000w
w0w0w0w0w0w0w0w
w000w000w000w0w
w0w0w0w0w0w0w0w
w0w000w000w000w
w0w0w0w0w0w0w0w
w000w000w00000w
w0w0w0w0w0w0w0w
w0w000w000w000w
w0w0w0w0w0w0w0w
w000w000w000w0w
w0w0w0w0w0w0w0w
w0000000000000w
wwwwwwwwwwwwwww